Zork
A Computerized Fantasy Simulation Game by Infocom -- Ported by Dean Menezes
Release 3 / Serial number 230619 / Inform 7 build 5J39 (I6/v6.31 lib 6/11N) SD

West of House
You are in an open field on the west side of a white house with a boarded front door.

There is a small mailbox here.
A rubber mat saying "Welcome to Zork" lies by the door.

>look
West of House
You are in an open field on the west side of a white house with a boarded front door.

There is a small mailbox here.
A rubber mat saying "Welcome to Zork" lies by the door.

>e
The door is locked, and there is evidently no key.

>w
Forest
This is a forest with trees in all directions around you.

You hear in the distance the chirping of a song bird.

>e
Forest
This is a dimly lit forest, with large trees all around.  One particularly large tree with some low branches stands here.

* * *

>look
West of House
You are in an open field on the west side of a white house with a boarded front door.

There is a small mailbox here.
A rubber mat saying "Welcome to Zork" lies by the door.

>w
Forest
This is a forest with trees in all directions around you.

You hear in the distance the chirping of a song bird.

>e
Forest
This is a dimly lit forest, with large trees all around.  One particularly large tree with some low branches stands here.

You hear in the distance the chirping of a song bird.

>look
Forest
This is a dimly lit forest, with large trees all around.  One particularly large tree with some low branches stands here.

>e
Clearing
This is a clearing, with a forest surrounding you on the west and south.

There is a pile of leaves on the ground.

>w
Forest

>w
North of House
You are facing the north side of a white house.  There is no door here, and all the windows are barred.

>w
West of House
There is a small mailbox here.
A rubber mat saying "Welcome to Zork" lies by the door.

>look
West of House
You are in an open field on the west side of a white house with a boarded front door.

There is a small mailbox here.
A rubber mat saying "Welcome to Zork" lies by the door.

>n
North of House
You are facing the north side of a white house.  There is no door here, and all the windows are barred.

>look
North of House
You are facing the north side of a white house.  There is no door here, and all the windows are barred.

>n
Forest
This is a dimly lit forest, with large trees all around.  One particularly large tree with some low branches stands here.

You hear in the distance the chirping of a song bird.

>look
Forest
This is a dimly lit forest, with large trees all around.  One particularly large tree with some low branches stands here.

>up
Up a Tree
You are about ten feet above the ground nestled among some large branches. The nearest branch above you is beyond your reach.

On the branch is a small birds nest.  In the bird's nest is a large egg encrusted with precious jewels, apparently scavenged somewhere by a childless songbird.  The egg is covered with fine gold inlay and ornamented in lapis lazuli and mother-of-pearl.  Unlike most eggs, this one is hinged and has a delicate looking clasp holding it closed. The egg appears extremely fragile.

>look
Up a Tree
You are about ten feet above the ground nestled among some large branches. The nearest branch above you is beyond your reach.

On the branch is a small birds nest.  In the bird's nest is a large egg encrusted with precious jewels, apparently scavenged somewhere by a childless songbird.  The egg is covered with fine gold inlay and ornamented in lapis lazuli and mother-of-pearl.  Unlike most eggs, this one is hinged and has a delicate looking clasp holding it closed. The egg appears extremely fragile.

>down
Forest
You hear in the distance the chirping of a song bird.

>look
Forest
This is a dimly lit forest, with large trees all around.  One particularly large tree with some low branches stands here.

You hear in the distance the chirping of a song bird.

>n
Forest
This is a dimly lit forest, with large trees all around.  To the east, there appears to be sunlight.

>look
Forest
This is a dimly lit forest, with large trees all around.  To the east, there appears to be sunlight.

>n
South of House
You are facing the south side of a white house.  There is no door here, and all the windows are barred.

>e
Behind House
You are behind the white house.  In one corner of the house is a window that is slightly ajar.

>e
Clearing
This is a clearing, with a forest surrounding you on the west and south.

There is a pile of leaves on the ground.

>look
Clearing
This is a clearing, with a forest surrounding you on the west and south.

There is a pile of leaves on the ground.

>look pile
I only understood you as far as wanting to look.

>x pile
You see nothing special about the pile of leaves.

>go house
You can't see any such thing.

>go north house
I only understood you as far as wanting to go north.

* * *

Zork
A Computerized Fantasy Simulation Game by Infocom -- Ported by Dean Menezes
Release 3 / Serial number 230619 / Inform 7 build 5J39 (I6/v6.31 lib 6/11N) SD

West of House
You are in an open field on the west side of a white house with a boarded front door.

There is a small mailbox here.
A rubber mat saying "Welcome to Zork" lies by the door.

>n
North of House
You are facing the north side of a white house.  There is no door here, and all the windows are barred.

I beg your pardon?

I beg your pardon?

>look
North of House
You are facing the north side of a white house.  There is no door here, and all the windows are barred.

* * *

>look
Behind House
You are behind the white house.  In one corner of the house is a window that is slightly ajar.

>s
South of House
You are facing the south side of a white house.  There is no door here, and all the windows are barred.

>look
South of House
You are facing the south side of a white house.  There is no door here, and all the windows are barred.

* * *

>n
North of House
You are facing the north side of a white house.  There is no door here, and all the windows are barred.

>s
You can't go that way.

>south
You can't go that way.

* * *

>s
You can't go that way.

>w
West of House
There is a small mailbox here.
A rubber mat saying "Welcome to Zork" lies by the door.

* * *

>n
North of House
You are facing the north side of a white house.  There is no door here, and all the windows are barred.

>e
Behind House
You are behind the white house.  In one corner of the house is a window that is slightly ajar.

>look
Behind House
You are behind the white house.  In one corner of the house is a window that is slightly ajar.

>w
You can't, since the window is in the way.

>look
Behind House
You are behind the white house.  In one corner of the house is a window that is slightly ajar.

* * *

>look
North of House
You are facing the north side of a white house.  There is no door here, and all the windows are barred.

* * *

>e
Behind House
You are behind the white house.  In one corner of the house is a window that is slightly ajar.

>s
South of House
You are facing the south side of a white house.  There is no door here, and all the windows are barred.

* * *

>n
North of House
You are facing the north side of a white house.  There is no door here, and all the windows are barred.

>w
West of House
There is a small mailbox here.
A rubber mat saying "Welcome to Zork" lies by the door.

* * *

>n
North of House
You are facing the north side of a white house.  There is no door here, and all the windows are barred.

>n
Forest
This is a dimly lit forest, with large trees all around.  One particularly large tree with some low branches stands here.

You hear in the distance the chirping of a song bird.

>n
Forest
This is a dimly lit forest, with large trees all around.  To the east, there appears to be sunlight.

You hear in the distance the chirping of a song bird.

>look
Forest
This is a dimly lit forest, with large trees all around.  To the east, there appears to be sunlight.

* * *

>n
Forest
This is a dimly lit forest, with large trees all around.  One particularly large tree with some low branches stands here.

You hear in the distance the chirping of a song bird.

>look
Forest
This is a dimly lit forest, with large trees all around.  One particularly large tree with some low branches stands here.

You hear in the distance the chirping of a song bird.

>sw
You can't go that way.

>se
You can't go that way.

>ne
You can't go that way.

>nw
You can't go that way.

You hear in the distance the chirping of a song bird.

>south west
I only understood you as far as wanting to south.

>n
Forest
This is a dimly lit forest, with large trees all around.  To the east, there appears to be sunlight.

You hear in the distance the chirping of a song bird.

* * *

>look
Forest
This is a dimly lit forest, with large trees all around.  To the east, there appears to be sunlight.

>sw
You can't go that way.

>ne
You can't go that way.

>n
South of House
You are facing the south side of a white house.  There is no door here, and all the windows are barred.

>s
Forest

>look
Forest
This is a dimly lit forest, with large trees all around.  To the east, there appears to be sunlight.

>ne
You can't go that way.

>sw
You can't go that way.

>e
Clearing
This is a clearing, with a forest surrounding you on the west and south.

There is a pile of leaves on the ground.

* * *

>look
Clearing
This is a clearing, with a forest surrounding you on the west and south.

There is a pile of leaves on the ground.

>sw
Behind House
You are behind the white house.  In one corner of the house is a window that is slightly ajar.

>e
Clearing
There is a pile of leaves on the ground.

>ne
You can't go that way.

>e
You can't go that way.

* * *

>look
Forest
This is a dimly lit forest, with large trees all around.  To the east, there appears to be sunlight.

>se
You can't go that way.

>nw
You can't go that way.

You hear in the distance the chirping of a song bird.

>n
South of House
You are facing the south side of a white house.  There is no door here, and all the windows are barred.

>w
West of House
There is a small mailbox here.
A rubber mat saying "Welcome to Zork" lies by the door.

>w
Forest
This is a forest with trees in all directions around you.

>look
Forest
This is a forest with trees in all directions around you.

>w
Forest

>look
Forest
This is a forest with trees in all directions around you.

>s
Forest

* * *

>look
Forest
This is a dimly lit forest, with large trees all around.  To the east, there appears to be sunlight.

>e
Clearing
This is a clearing, with a forest surrounding you on the west and south.

There is a pile of leaves on the ground.

* * *

>look
Forest
This is a dimly lit forest, with large trees all around.  One particularly large tree with some low branches stands here.

You hear in the distance the chirping of a song bird.

>se
You can't go that way.

>southeast
You can't go that way.

>e
Clearing
This is a clearing, with a forest surrounding you on the west and south.

There is a pile of leaves on the ground.

* * *

>w
Forest

>look
Forest
This is a dimly lit forest, with large trees all around.  One particularly large tree with some low branches stands here.

>se
You can't go that way.

You hear in the distance the chirping of a song bird.

>nw
You can't go that way.

* * *

Zork
A Computerized Fantasy Simulation Game by Infocom -- Ported by Dean Menezes
Release 3 / Serial number 230619 / Inform 7 build 5J39 (I6/v6.31 lib 6/11N) SD

West of House
You are in an open field on the west side of a white house with a boarded front door.

There is a small mailbox here.
A rubber mat saying "Welcome to Zork" lies by the door.

I beg your pardon?

>help
> Introduction to Zork
   Instructions for Play
   InvisiClues Hints

>n
Introduction to Zork
 > Instructions for Play
   InvisiClues Hints

   Introduction to Zork
 > Instructions for Play
   InvisiClues Hints

>o
Introduction to Zork
 > Instructions for Play
   InvisiClues Hints

>r
Introduction to Zork
 > Instructions for Play
   InvisiClues Hints

>n
Introduction to Zork
   Instructions for Play
 > InvisiClues Hints

   Introduction to Zork
   Instructions for Play
 > InvisiClues Hints

>q
West of House
You are in an open field on the west side of a white house with a boarded front door.

There is a small mailbox here.
A rubber mat saying "Welcome to Zork" lies by the door.

>north
North of House
You are facing the north side of a white house.  There is no door here, and all the windows are barred.

>look
North of House
You are facing the north side of a white house.  There is no door here, and all the windows are barred.

* * *

I beg your pardon?

>n
North of House
You are facing the north side of a white house.  There is no door here, and all the windows are barred.

* * *

>look
South of House
You are facing the south side of a white house.  There is no door here, and all the windows are barred.

* * *

I beg your pardon?

>look
West of House
You are in an open field on the west side of a white house with a boarded front door.

There is a small mailbox here.
A rubber mat saying "Welcome to Zork" lies by the door.

>s
South of House
You are facing the south side of a white house.  There is no door here, and all the windows are barred.

>e
Behind House
You are behind the white house.  In one corner of the house is a window that is slightly ajar.

* * *

>look
South of House
You are facing the south side of a white house.  There is no door here, and all the windows are barred.

I beg your pardon?

>se
You can't go that way.

>sw
You can't go that way.

>sw
You can't go that way.

>e
Behind House
You are behind the white house.  In one corner of the house is a window that is slightly ajar.

* * *

>look
Clearing
This is a clearing, with a forest surrounding you on the west and south.

There is a pile of leaves on the ground.

>s
Forest
This is a dimly lit forest, with large trees all around.  To the east, there appears to be sunlight.

>look
Forest
This is a dimly lit forest, with large trees all around.  To the east, there appears to be sunlight.

You hear in the distance the chirping of a song bird.

>e
Clearing
There is a pile of leaves on the ground.

>look
Clearing
This is a clearing, with a forest surrounding you on the west and south.

There is a pile of leaves on the ground.

>take pile
Moving the pile of leaves reveals a grating.

>look grating
I only understood you as far as wanting to look.

>open grating
It seems to be locked.

>unlock grating
(with the pile of leaves)
That doesn't seem to fit the lock.

>s
Forest
You hear in the distance the chirping of a song bird.

>look
Forest
This is a dimly lit forest, with large trees all around.  To the east, there appears to be sunlight.

You hear in the distance the chirping of a song bird.

>w
Forest
This is a forest with trees in all directions around you.

* * *

>look
Forest
This is a forest with trees in all directions around you.

>look
Forest
This is a forest with trees in all directions around you.

>e
Forest
This is a dimly lit forest, with large trees all around.  One particularly large tree with some low branches stands here.

>look
Forest
This is a dimly lit forest, with large trees all around.  One particularly large tree with some low branches stands here.

>n
Forest

>look
Forest
This is a dimly lit forest, with large trees all around.  To the east, there appears to be sunlight.

>e
Clearing

>look
Clearing
This is a clearing, with a forest surrounding you on the west and south.

>w
Forest

>look
Forest
This is a dimly lit forest, with large trees all around.  One particularly large tree with some low branches stands here.

You hear in the distance the chirping of a song bird.

>climb tree
Up a Tree
You are about ten feet above the ground nestled among some large branches. The nearest branch above you is beyond your reach.

On the branch is a small birds nest.  In the bird's nest is a large egg encrusted with precious jewels, apparently scavenged somewhere by a childless songbird.  The egg is covered with fine gold inlay and ornamented in lapis lazuli and mother-of-pearl.  Unlike most eggs, this one is hinged and has a delicate looking clasp holding it closed. The egg appears extremely fragile.

>look
Up a Tree
You are about ten feet above the ground nestled among some large branches. The nearest branch above you is beyond your reach.

On the branch is a small birds nest.  In the bird's nest is a large egg encrusted with precious jewels, apparently scavenged somewhere by a childless songbird.  The egg is covered with fine gold inlay and ornamented in lapis lazuli and mother-of-pearl.  Unlike most eggs, this one is hinged and has a delicate looking clasp holding it closed. The egg appears extremely fragile.

>down
Forest

>look
Forest
This is a dimly lit forest, with large trees all around.  One particularly large tree with some low branches stands here.

* * *

I beg your pardon?

>s
South of House
You are facing the south side of a white house.  There is no door here, and all the windows are barred.

* * *

>e
Clearing
This is a clearing, with a forest surrounding you on the west and south.

There is a pile of leaves on the ground.

>s
Forest
This is a dimly lit forest, with large trees all around.  To the east, there appears to be sunlight.

You hear in the distance the chirping of a song bird.

>look
Forest
This is a dimly lit forest, with large trees all around.  To the east, there appears to be sunlight.

* * *

Zork
A Computerized Fantasy Simulation Game by Infocom -- Ported by Dean Menezes
Release 3 / Serial number 230619 / Inform 7 build 5J39 (I6/v6.31 lib 6/11N) SD

West of House
You are in an open field on the west side of a white house with a boarded front door.

There is a small mailbox here.
A rubber mat saying "Welcome to Zork" lies by the door.

>e
The door is locked, and there is evidently no key.

>e
The door is locked, and there is evidently no key.

>ne
You can't go that way.

>look
West of House
You are in an open field on the west side of a white house with a boarded front door.

There is a small mailbox here.
A rubber mat saying "Welcome to Zork" lies by the door.

* * *

>e
The door is locked, and there is evidently no key.

>s
South of House
You are facing the south side of a white house.  There is no door here, and all the windows are barred.

>x window
You can't see any such thing.

>examine window
You can't see any such thing.

>enter window
You can't see any such thing.

>look
South of House
You are facing the south side of a white house.  There is no door here, and all the windows are barred.

>n
You can't go that way.

>e
Behind House
You are behind the white house.  In one corner of the house is a window that is slightly ajar.

>look window
I only understood you as far as wanting to look.

>enter window
You can't, since the window is in the way.

>go window
You can't, since the window is in the way.

>look
Behind House
You are behind the white house.  In one corner of the house is a window that is slightly ajar.

>look window
I only understood you as far as wanting to look.

>examine window
You see nothing special about the window.

>open window
With great effort, you open the window far enough to allow entry.

>enter window
Kitchen
This is the kitchen of the white house.  A table seems to have been used recently for the preparation of food.  A passage leads to the west, and a dark staircase can be seen leading upward.  A dark chimney leads down and to the east is a small window which is open. 

On the table is an enlongated brown sack, smelling of hot peppers.
Sitting on the table is a small bottle.
The bottle contains:
  a quantity of water

>look
Kitchen
This is the kitchen of the white house.  A table seems to have been used recently for the preparation of food.  A passage leads to the west, and a dark staircase can be seen leading upward.  A dark chimney leads down and to the east is a small window which is open. 

On the table is an enlongated brown sack, smelling of hot peppers.
Sitting on the table is a small bottle.
The bottle contains:
  a quantity of water

>w
Living Room
This is the living room.  There is a door to the east.  To the west, there is a wooden door with strange gothic lettering, which appears to be nailed shut. 

In center of the room is a large oriental rug.
There is a trophy case here.
On hooks above the mantelpiece hangs an elvish sword of great antiquity.
A battery powered brass lantern is on the trophy case.
There is an issue of US NEWS & DUNGEON REPORT here.

>look
Living Room
This is the living room.  There is a door to the east.  To the west, there is a wooden door with strange gothic lettering, which appears to be nailed shut. 

In center of the room is a large oriental rug.
There is a trophy case here.
On hooks above the mantelpiece hangs an elvish sword of great antiquity.
A battery powered brass lantern is on the trophy case.
There is an issue of US NEWS & DUNGEON REPORT here.

>w
You can't, since the wooden door is in the way.

>e
Kitchen
On the table is an enlongated brown sack, smelling of hot peppers.
Sitting on the table is a small bottle.
The bottle contains:
  a quantity of water

>look
Kitchen
This is the kitchen of the white house.  A table seems to have been used recently for the preparation of food.  A passage leads to the west, and a dark staircase can be seen leading upward.  A dark chimney leads down and to the east is a small window which is open. 

On the table is an enlongated brown sack, smelling of hot peppers.
Sitting on the table is a small bottle.
The bottle contains:
  a quantity of water

>up
Darkness
It is pitch black.  You are likely to be eaten by a grue.

>look
Darkness
It is pitch black.  You are likely to be eaten by a grue.

>down
Kitchen
On the table is an enlongated brown sack, smelling of hot peppers.
Sitting on the table is a small bottle.
The bottle contains:
  a quantity of water

>take bottle
Taken.

>w
Living Room
In center of the room is a large oriental rug.
There is a trophy case here.
On hooks above the mantelpiece hangs an elvish sword of great antiquity.
A battery powered brass lantern is on the trophy case.
There is an issue of US NEWS & DUNGEON REPORT here.

>look
Living Room
This is the living room.  There is a door to the east.  To the west, there is a wooden door with strange gothic lettering, which appears to be nailed shut. 

In center of the room is a large oriental rug.
There is a trophy case here.
On hooks above the mantelpiece hangs an elvish sword of great antiquity.
A battery powered brass lantern is on the trophy case.
There is an issue of US NEWS & DUNGEON REPORT here.

>take battery
You can't see any such thing.

>take lantern
Taken.

>look
Living Room
This is the living room.  There is a door to the east.  To the west, there is a wooden door with strange gothic lettering, which appears to be nailed shut. 

In center of the room is a large oriental rug.
There is a trophy case here.
On hooks above the mantelpiece hangs an elvish sword of great antiquity.
There is an issue of US NEWS & DUNGEON REPORT here.

>open trophy
You open the trophy case.

>take sword
Taken.

>look
Living Room
This is the living room.  There is a door to the east.  To the west, there is a wooden door with strange gothic lettering, which appears to be nailed shut. 

In center of the room is a large oriental rug.
There is a trophy case here.
There is an issue of US NEWS & DUNGEON REPORT here.

>move rug
With a great effort, the rug is moved to one side of the room. With the rug moved, the dusty cover of a closed trap door appears.

>up
You can't go that way.

>e
Kitchen
On the table is an enlongated brown sack, smelling of hot peppers.

>up
Darkness

>light lantern
You switch the battery-powered brass lantern on.

Attic
This is the Attic.  The only exit is stairs that lead down.

There is a large coil of rope here.

There is a square brick here which feels like clay.
On a table is a nasty-looking knife.

>take rope
Taken.

>take knife
Taken.

>look
Attic
This is the Attic.  The only exit is stairs that lead down.

There is a square brick here which feels like clay.

>take square
Taken.

>look
Attic
This is the Attic.  The only exit is stairs that lead down.

>unlight lanternù
That's not a verb I recognise.

>power off lantern
That's not a verb I recognise.

>off lantern
That's not a verb I recognise.

>light off lantern
You can't see any such thing.

>d
Kitchen
On the table is an enlongated brown sack, smelling of hot peppers.

>look
Kitchen
This is the kitchen of the white house.  A table seems to have been used recently for the preparation of food.  A passage leads to the west, and a dark staircase can be seen leading upward.  A dark chimney leads down and to the east is a small window which is open. 

On the table is an enlongated brown sack, smelling of hot peppers.

>e
Behind House

>e
Clearing
This is a clearing, with a forest surrounding you on the west and south.

There is a pile of leaves on the ground.

>remove pile
(first taking the pile of leaves)
Moving the pile of leaves reveals a grating.

You're not wearing that.

>open grating
It seems to be locked.

>unlock grating
What do you want to unlock the grating with?

>with knife
You can't see any such thing.

>unlock grating with knife
That doesn't seem to fit the lock.

>look
Clearing
This is a clearing, with a forest surrounding you on the west and south.

>i
You are carrying:
  a pile of leaves
  a square brick feeling like clay
  a nasty-looking knife
  a large coil of rope
  an elvish sword
  a battery-powered brass lantern (providing light)
  a bottle (closed)
    a quantity of water

>unlock grating with knife
That doesn't seem to fit the lock.

>unlock grating with square
That doesn't seem to fit the lock.

>unlock grating with sword
That doesn't seem to fit the lock.

>open grating
It seems to be locked.

>d
You are unable to descend by the grating.

>help
> Introduction to Zork
   Instructions for Play
   InvisiClues Hints

>e
> Introduction to Zork
   Instructions for Play
   InvisiClues Hints

>[back]
> Introduction to Zork
   Instructions for Play
   InvisiClues Hints

>q
Clearing
This is a clearing, with a forest surrounding you on the west and south.

>light off lantern
You can't see any such thing.

>i
You are carrying:
  a pile of leaves
  a square brick feeling like clay
  a nasty-looking knife
  a large coil of rope
  an elvish sword
  a battery-powered brass lantern (providing light)
  a bottle (closed)
    a quantity of water

>light ogg lantern
You can't see any such thing.

>power off lantern
That's not a verb I recognise.

>switch off lantern
You switch the battery-powered brass lantern off.

>look
Clearing
This is a clearing, with a forest surrounding you on the west and south.

>s
Forest
This is a dimly lit forest, with large trees all around.  To the east, there appears to be sunlight.

>look
Forest
This is a dimly lit forest, with large trees all around.  To the east, there appears to be sunlight.

* * *

>look
Clearing
This is a clearing, with a forest surrounding you on the west and south.

>s
Forest

>w
Forest
This is a forest with trees in all directions around you.

* * *

>look
Forest
This is a forest with trees in all directions around you.

>n
Forest

>look
Forest
This is a forest with trees in all directions around you.

* * *

>n
Forest

>look
Forest
This is a dimly lit forest, with large trees all around.  To the east, there appears to be sunlight.

You hear in the distance the chirping of a song bird.

>look
Forest
This is a dimly lit forest, with large trees all around.  To the east, there appears to be sunlight.

* * *

Zork
A Computerized Fantasy Simulation Game by Infocom -- Ported by Dean Menezes
Release 3 / Serial number 230619 / Inform 7 build 5J39 (I6/v6.31 lib 6/11N) SD

West of House
You are in an open field on the west side of a white house with a boarded front door.

There is a small mailbox here.
A rubber mat saying "Welcome to Zork" lies by the door.

>s
South of House
You are facing the south side of a white house.  There is no door here, and all the windows are barred.

* * *

>look
Clearing
This is a clearing, with a forest surrounding you on the west and south.

There is a pile of leaves on the ground.

>se
Forest
This is a forest with trees in all directions around you.

>ne
You can't go that way.

>n
Forest

* * *

>look
Forest
This is a forest with trees in all directions around you.

>se
Canyon View

>d
You can't go that way.

>look
Canyon View

>examine canyon view
You can't see any such thing.

>look
Canyon View

>down
You can't go that way.

>up
You can't go that way.

>sw
You can't go that way.

>n
You can't go that way.

* * *

>look
South of House
You are facing the south side of a white house.  There is no door here, and all the windows are barred.

>se
You can't go that way.

>s
Forest
This is a dimly lit forest, with large trees all around.  To the east, there appears to be sunlight.

You hear in the distance the chirping of a song bird.

* * *

>look
Clearing
This is a clearing, with a forest surrounding you on the west and south.

There is a pile of leaves on the ground.

>look
Clearing
This is a clearing, with a forest surrounding you on the west and south.

There is a pile of leaves on the ground.

>e
You can't go that way.

>se
Forest
This is a forest with trees in all directions around you.

You hear in the distance the chirping of a song bird.

>look
Forest
This is a forest with trees in all directions around you.

You hear in the distance the chirping of a song bird.

* * *

>look
South of House
You are facing the south side of a white house.  There is no door here, and all the windows are barred.

>s
Forest
This is a dimly lit forest, with large trees all around.  To the east, there appears to be sunlight.

You hear in the distance the chirping of a song bird.

>n
South of House

>look
South of House
You are facing the south side of a white house.  There is no door here, and all the windows are barred.

* * *

>s
South of House
You are facing the south side of a white house.  There is no door here, and all the windows are barred.

>se
Canyon View
You are at the top of the Great Canyon on its south wall.  From here there is a marvelous view of the Canyon and parts of the Frigid River upstream.  Across the canyon, the walls of the White Cliffs still appear to loom far above.  Following the Canyon upstream (north and northwest), Aragain Falls may be seen, complete with rainbow. Fortunately, my vision is better than average and I can discern the top of the Flood Control Dam #3 far to the distant north.  To the west and south can be seen an immense forest, stretching for miles around.  It is possible to climb down into the canyon from here.

>d
Rocky Ledge
You are on a ledge about halfway up the wall of the river canyon. You can see from here that the main flow from Aragain Falls twists along a passage which it is impossible to enter.  Below you is the canyon bottom.  Above you is more cliff, which still appears climbable.

>nw
You can't go that way.

>up
Canyon View

>nw
South of House

* * *

>look
Canyon View
You are at the top of the Great Canyon on its south wall.  From here there is a marvelous view of the Canyon and parts of the Frigid River upstream.  Across the canyon, the walls of the White Cliffs still appear to loom far above.  Following the Canyon upstream (north and northwest), Aragain Falls may be seen, complete with rainbow. Fortunately, my vision is better than average and I can discern the top of the Flood Control Dam #3 far to the distant north.  To the west and south can be seen an immense forest, stretching for miles around.  It is possible to climb down into the canyon from here.

>d
Rocky Ledge
You are on a ledge about halfway up the wall of the river canyon. You can see from here that the main flow from Aragain Falls twists along a passage which it is impossible to enter.  Below you is the canyon bottom.  Above you is more cliff, which still appears climbable.

>look
Rocky Ledge
You are on a ledge about halfway up the wall of the river canyon. You can see from here that the main flow from Aragain Falls twists along a passage which it is impossible to enter.  Below you is the canyon bottom.  Above you is more cliff, which still appears climbable.

>d
Canyon Bottom
You are beneath the walls of the river canyon which may be climbable here.  There is a small stream here, which is the lesser part of the runoff of Aragain Falls. To the north is a narrow path.

>look
Canyon Bottom
You are beneath the walls of the river canyon which may be climbable here.  There is a small stream here, which is the lesser part of the runoff of Aragain Falls. To the north is a narrow path.

>n
End of Rainbow
You are on a small, rocky beach on the continuation of the Frigid River past the Falls.  The beach is narrow due to the presence of the White Cliffs.  The river canyon opens here and sunlight shines in from above. A rainbow crosses over the falls to the west and a narrow path continues to the southeast.

>look
End of Rainbow
You are on a small, rocky beach on the continuation of the Frigid River past the Falls.  The beach is narrow due to the presence of the White Cliffs.  The river canyon opens here and sunlight shines in from above. A rainbow crosses over the falls to the west and a narrow path continues to the southeast.